10 7
##########  
#        #
#  $   @ #  
#     #  #
#  .     #
#        #
##########
